WE ./textures/1.xpm
EA ./textures/3.xpm
NO ./textures/2.xpm
SO ./textures/4.xpm

C 139,139,179
F 60,20,82



11111111111111111111
10010000000111000001
11111111101100000001
100000E0000000011111
11110101110000010001
11110111101010010001
11000001101010111001
10000001100000010001
10000000001010010001
11111111111111111111
