NO ./textures/Brickwall3_Texture.xpm
SO ./textures/../textures/Brickwall4_Texture.xpm





WE ./textures/Brickwall5_Texture.xpm
EA ./textures/Stonewall_Texture.xpm





C 250,0,10




F 225,100,0
F 225,100,0



11111111111111111111111111
10010000000111000001111
11111111101100000001
10001W000000011111
11110101110000010001
11110111101010010001
11000001101010111001
10000001100000010001
10000010001010010001
11001111111111111111
1000011
1000011
1000011
1000011
1000011
1111111
1111111
1111111
1100111
1111111
1111111
