NO ./textures/Brickwall3_Texture.xpm
SO ./textures/Brickwall4_Texture.xpm
WE ./textures/Brickwall5_Texture.xpm
EA ./textures/onewall_Texture.xpm

F 220,100,0
C 225,30,0
			1111
	100001					1001
		  11111111		1111
1111111111111110000001111
1000000000110000000000001   111
101100000111000000000000111111111
100100000000000000000000111000001
111111111011000001110000000000001
100000000011000001110111111111111
11110111111111011100000010001
11110111111111011101010010001
11000000110101011100000010001
10000000000000001100000010001
10000000000000001101010010001
11000001111101011111011110N0111
11110111  1110101 101111010001
11111111 1111111 111111111111
