NO ./textures/bricks.xpm
SO ./textures/circles.xpm
WE ./textures/hypno.xpm
EA ./textures/wood.xpm

C 255,255,255
F 255,0,0



11111111111111111111
10010000000111000001
11111111101100000001
100000W0000000011111
11110101110000010001
11110111101010010001
11000001101010111001
10000001100000010001
10000000001010010001
11111111111111111111
