NO ./path_to_the_north_texture
WE ./path_to_the_west_texture

C 					     225,30,0


SO 			./path_to_the_south_texture
EA ./path_to_the_east_texture

F 220,100,0

1111111111111111111111111111
100000000011000000000000111111
1011000001110000000000001   1111
100100000000000000000000111111111
111111111011000001110000000000001
100000000011000001110111111111111
111101111111110111000000100011
1111011111 1111011101010010001
110000001111010111000000100011
10000000000000001100000010001
10000000000000001101010010001
11000001110101011111011110N0111
111100000111111101011101111011
11111111111111111111111111111





