NO 				./textures/Brickwall3_Texture.xpm



SO ./textures/Brickwall4_Texture.xpm
WE ./textures/Brickwall5_Texture.xpm
EA ./textures/Stonewall_Texture.xpm

F 220,100,0
C 225,30,0





   1111111111111111111111111
11110000000110000000000001
1011000001110000000000001
100100000000000000000000111111111
111111111011000001110000000000001
100000000011000001110111111111111
11110111111111011100000010001
11110111111111011101010010001
11000000110101011100000010001
10000W00000000001100000010001
100000N0000000001101010010001
11000001110101011111011110N0111
11110111 1110101 101111010001
11111111 1111111 111111111111
